1111111111111111111111111111111111
1E0010000000000C00000C000000000001
1010010100100000101001000000010101
1010010010P01010101110010000101011
110000000C00C0000000000000000000C1
1111111111111111111111111111111111