1111111111111111111111111111111111
100010000000000C00000C000000000001
1010010010101010101110010000101011
11001CC000001000000C0000E00C000001
1010010100100C0010100100C000010101
1010010010P01010101110010000101011
110000000C00C000000C000C00000000C1
11000C0000C00M0C0000000000C0000001
1010010100100C00101001000000010101
1111111111111111111111111111111111