1111111111111
1E010C01C1001
1100010101001
1PC0110000001
1111111111111