1111111111111
10010000C0001
100M011111001
1P0011E000001
1111111111111