111111111111111111111111111111111111111111111
1E0000000000000C00000C00000000000011000000001
101001010010000010100100000001010010100101001
101001001010101000100100000001010010100100101
100000000C00C0000000000000000000C01P0000000C1
110000000000000C00000C00000000000011000000001
101001010010000010100100000001010010100101001
101001001010101000100100000001010010100100101
100000000C00C0000000000000000000C0000000000C1
100000000C00C0000000000000000000C0000000000C1
100000000C00C0000000000000000000C0000000000C1
100000000C00C0000000000000000000C0000000000C1
100000000C00C0000000000000000000C0000000000C1
100000000C00C0000000000000000000C000000000001
100000000C00C0000000000000000000C0000000000C1
100000000C00C0000000000000000000C0000000000C1
100000000C00C0000000000000000000C0000000000C1
111111111111111111111111111111111111111111111